Stefan Korboński
Jędrzyj Giertych
Polska i Niemcy - Jędrzej Giertych
Mackiewicz napisał cztery książki po polsku o Katyniu: ("Sprawa mordu katyńskiego : ta książka była pierwsza", "Zbrodnia katyńska w świetle dokumentów", "Ponary Katyń", "Katyń. Zbrodnia bez sądu i kary")
Myśli nowoczesnego Polaka - Dmowski
Świat powojenny i Polska - Dmowski
Myśli nowoczesnego endeka - Ziemkiewicz
Bestie - Płużański
O Najnowszej Historii Polski 1939-1989 - Leszek Żebrowski
Cywilizacja żydowska - Koneczny
Zaporczycy w fotografii 1943 - 1963 - Ewa Kurek
Żydzi, Polacy, czy po prostu ludzie...18 lat później - Ewa Kurek
Dzieci żydowskie w klasztorach - Ewa Kurek
Jedwabne: Anatomia kłamstwa - Ewa Kurek
Poza granicą solidarności. Stosunki polsko-żydowskie 1939-1945 - Ewa Kurek
Boże Igrzysko - Norman Davies
Szlak Nadziei - Norman Davies
Nowe kłamstwa Grossa - Jerzy Robert Nowak
Sto kłamstw Grossa o Jedwabnem i żydowskich sąsiadach - Jerzy Robert Nowak
Przemilczane zbrodnie: Zydzi i Polacy na Kresach w latach 1939-1941 - Jerzy Robert Nowak
Walka z kościołem wczoraj i dziś - jerzy Robert Nowak
Myśli o Polsce i Polakach - Jerzy Robert Nowak
Zagrożenia dla Polski i Polskości - Jerzy Robert Nowak
Alleluja i Pod Prad - Jerzy Robert Nowak
Najnowsze kłopoty z historią - Piotr Gontarczyk
Czarny ptasior - Joanna Siedlecka
Dziennik z lat okupacji Zamojszczyzny 1939–1944 - Zygmunt Klukowski
Byłem dowódcą Brygady Świętokrzyskiej - Antoni Szacki
Dziennik 1941–1943 - Kazimierz Sakowicz
Rozmowy z katem - Kazimierz Moczarski
Zagłada Żydów w Krakowie - Aleksander Biberstein
Armia podziemna - Tadeusz Bór Komorowski
Dziedzictwo Orła Białego - Julian Eugeniusz Kulski
Nadmiar pamięci (Siedem owych lat). Wspomnienia 1939–1946 - Icchak Cukierman
Przez Druty, Kraty I Kajdany: Wspomnienia Partyzanta Nsz - Piotr Kosobudzki
Wspomnienia dawne i nowe - Franciszek Ząbecki
CZY JA JESTEM MORDERCĄ? - CALEL PERECHODNIK
Pamiętniki - Józef Haller
Chłop polski w Europie i Ameryce - William Isaac Thomas i Florian Znanecki
Więcej niż niepodległość: Polska myśl polityczna 1918–1939 - Jan Jachymek
Nacjonalizm chrześcijański - Bogumił Grott
Między nauką a mistyfikacją - Jerzy Muszyński
Enigma - Józef Garliński
Wojna Polsko-Sowiecka 1939 - Ryszard Szawłowski
Wojna 1920 roku na Mazowszu i Podlasiu - Janusz Szczepański
Fałszowanie historii najnowszej Ukrainy - Wiktor Poliszczuk
Wołyń naszych przodków: śladami życia - czas zagłady - Ewa Siemaszko
Ludobójstwo dokonane przez nacjonalistów ukraińskich na ludności polskiej Wołynia 1939-1945, t.1 i 2 - Władysław Siemaszko,  Ewa Siemaszko
Ludobójstwo dokonane przez nacjonalistów ukraińskich na Polakach w województwie tarnopolskim 1939-1946 - Henryk Komański
Narodowe Siy Zbrojne Na Podlasiu - Jerzy Rutkowski
Klechy w obozach śmierci - Henryk Maria Malak
Walka o dobra kultury. Warszawa 1939-1945 t.I - Stanisław Lorentz
Warszawa w Latach 1944-1949: Odbudowa - Jan Górski
Narodowa Demokracja: Antologia mysli politycznej “Przegladu Wszechpolskiego” (1895-1905) - Barbara Toruńczyk
Dywersja Niemiecka i Zbrodnie Hitlerowskie w Bydgoszczy na tle wydarzeń w dniu 3 IX 1939 - Edward Serwański
Dzieci Katynia - Teresa Kaczorowska


200 lat razem - Sołżenicyn
Garstka wybranych. Jak edukacja ukształtowała dzieje Żydów. 70-1492 - Maristella Botticini , Zvi Eckstein
Talmud - Abraham Cohen
Lewicowy faszyzm : tajemna historia amerykańskiej lewicy od Mussoliniego do polityki zmiany - Jonah Goldberg 
Widziałem Polskę zdradzoną - Arthur Bliss Lane
Skrwawione ziemie - Timothy Snyder
Tajna wojna - Timothy Snyder
Dziecięcy płacz - Richard C. Lukas
Zapomniany Holokaust. - Richard C. Lukas
Zatrute źródła Unii Europejskiej - John Laughland
Niepoprawna politycznie historia Stanów Zjednoczonych - Thomas Woods
Korzenie totalitaryzmu - Hannah Arendt
Eichmann w Jerozolimie - Hannah Arendt
Losy żydowskich żołnierzy Hitlera - Bryan Mark Rigg
Żydzi i życie gospodarcze - Werner Sombart
Skok dla życia.Pamiętnik z czasów okupacji Polski - Ruth Altbeker Cyprys
Rycerz Maryi. Misja i męczeństwo św. Maksymiliana Marii Kolbego - CLAUDE R. FOSTER
Polskie sieroty z Tengeru - Lynne Taylor
Masoneria zdemaskowana, czyli walka Antychrysta z Kościołem i z cywilizacją chrześcijańską - George F. Dillon
Wisła jak krew czerwona - Ron Jeffery
Polski ruch oporu 1939-1947 - David G. Williamson
Kultura krytyki. Ewolucjonistyczna analiza zaangażowania Żydów w XX-wieczne ruchy intelektualne i polityczne - Kevin B. MacDonald
Fenomen żydowski? Ze studiów nad etniczną aktywnością - Kevin B. MacDonald
Wiek Żydów - Yuri Slezkine
Ryszard Kukliński. Życie ściśle tajne - Benjamin Weiser
Ksiądz Henryk Jankowski Nie Ma Za Co Przepraszać - Peter Raina
Duchowe dziedzictwo Żydów polskich - Byron L. Sherwin
Ostatnie dni Romanowów - Robert Wilton
Osiemnasta decydująca bitwa w dziejach świata pod Warszawą 1920 r. - Edgar Vincent d'Abernon 


The Katyn Wood Murders - Józef Mackiewicz
In Defence of My Country - Jędrzej Giertych
Spanish Carlism and Polish Nationalism: The Borderlands of Europe in the 19th and 20th Centuries - Marek Jan Chodakiewicz
Between Nazis and Soviets: Occupation Politics in Poland, 1939-1947 - Marek Jan Chodakiewicz
To Whom Should the Jews Apologize? - Jerzy Robert Nowak
The Shame of Polish Historical Studies in America: The Blacklisting of Prof. Marek Jan Chodakiewicz - Sebastian Bojemski
Persecution of the Catholic Church in German Occupied Poland - August Hlond
Through a Woman's Eyes: Life in Poland Under the German Occupation - Maria Brzeska
The Jewish Question in Poland - Franciszek Bujak
And We Are Not Saved - David Wdowiński
World War II Through Polish Eyes - Maria Szonert-Binienda
Katyn: State-Sponsored Extermination - M.B. Szonert
Odilo Globocnik, Hitler's Man - Joseph Poprzeczny
The Emancipation of the Polish Peasantry - Stefan Kieniewicz
Wolyn Aflame - Filip Ozarowski
Jedrzejewicz: Diplomat in Berlin 1933-1939 -  Józef Lipski
Genocide And Rescue In Wołyn - Tadeusz Piotrowski
Dreams of Nationhood: American Jewish Communists and the Soviet Birobidzhan Project, 1924-1951 - Henry Felix Srebrnik
Seven Lies About Catholic History: Infamous Myths about the Church's Past and How to Answer Them - Diane Moczar
Polish Americans in California, 1827-1977 and Who's Who - Jacek Przygoda
German Camps,Polish Victims: The Irish Independent and its coverage of German-occupied Poland - Jan Niechwiadowicz
The PMI Compendium of anti-Polish sentiment - Jan Niechwiadowicz
German Camps,Polish Victims: The BBC coverage of German-occupied Poland - Jan Niechwiadowicz
The History of a Forgotten German Camp: Nazi Ideology and Genocide at Szmalcówka - Tomasz Ceran
The Unseen and the Silent: Adventures From the Underground Movement Narrated by Paratroops of the Polish Home Army - Kazimierz Iranek-Osmecki
Ludwik Hirszfeld: The Story of One Life - Ludwik Hirszfeld
Governor Frank's Dark Harvest - wacław śledziński
The Problem of Eastern Galicia - Stanislaw Skrzypek
Muslims in Poland, Their Origin, History, and Cultural Life - Leon Bohdanowicz
The Crime of Katyn: Facts and Documents - Zdzislaw Stahl
Polish Americans in California, Volume II - Gene Harubin Zygmunt


Why the Germans? Why the Jews?: Envy, Race Hatred, and the Prehistory of the Holocaust - Götz Aly
Hitler's Beneficiaries: Plunder, Racial War, and the Nazi Welfare State - Götz Aly
1949: The First Israelis - Tom Segev
Out of the Inferno: Poles Remember the Holocaust - Richard C. Lukas
A People That Shall Dwell Alone: Judaism as a Group Evolutionary Strategy, with Diaspora Peoples - Kevin B. MacDonald
Cultural Insurrections: Essays on Western Civilization, Jewish Influence, and Anti-Semitism - Kevin B. MacDonald
The Jewish War Front - Vladimir Jabotinsky (Ze'ew Żabotyński)
The Final Solution - Donald Bloxham
Germany Must Perish! - Theodore N. Kaufman
The Unquiet Ghost: Russians Remember Stalin - Adam Hochschild
Testimony: Contemporary Writers Make the Holocaust Personal - David Rosenberg
In the Shadow of the Reich - Niklas Frank
Zionism in Poland: The Formative Years, 1915-1926 - Ezra Mendelsohn
Essential Papers on Jews and the Left - Ezra Mendelsohn 
Jewish Identity in Early Rabbinic Writings - Sacha Stern
The Warriors - Harold Zissman
Nazi/Soviet Disinformation about the Holocaust in Latvia: Daugavas Vanagi: Who are they? - Andrew Ezergailis
The Holocaust Is Over: We Must Rise From its Ashes - Avraham Burg
Vorkuta - Edward Buca
The Echo of the Nazi Holocaust in Rabbinic Literature - H. J. Zimmels
Intelligence Co-operation between Poland and Great Britain during World War II - Tessa Stirling
The Holocaust Of Volhynian Jews: 1941-44 - Shmuel Spector
Holocaust: The Nazi Persecution and Murder of the Jews - Peter Longerich
Postville: A Clash of Cultures in Heartland America - Stephen G. Bloom
The Nation in the Village: The Genesis of Peasant National Identity in Austrian Poland, 1848-1914 - Keely Stauter-Halsted
Polish Memoirs - William John Rose (pamiętnika Jana Słomki?)
The Polish Tradition: an Interpretation of a Nation - Paul Super
Events and Personalities in Polish History - Paul Super
The history of the Armenian genocide - Vahakn N. Dadrian
Remembering a Vanished World: A Jewish Childhood in Interwar Poland - Theodore S. Hamerow
The Pavement of Hell: 3 Leaders of the Judenrat - Leonard Tushnet
Kolyma: The Arctic Death Camps - Robert Conquest
Kto Rukovodil Nkvd, 1934-1941: Spravochnik - Nikita Vasilevich Petrov
The Story of One Life - Ludwik Hirszfeld
Living Together, Living Apart: Rethinking Jewish-Christian Relations in the Middle Ages - Jonathan Elukin
Insiders and Outsiders: Dilemmas of East European Jewry - Richard I. Cohen, Jonathan Frankel, Stefani Hoffman
Trial of the Major War Criminals before the International Military Tribunal Volume 15 - International Military Tribunal
Iron Lazar: A Political Biography of Lazar Kaganovich - E.A. Rees
Reckless Rites: Purim and the Legacy of Jewish Violence - Elliott Horowitz
The Colors of War: The Siege of Warsaw in Julien Bryan's Color Photographs (Oblężenie/Siege) - Julien Bryans
Tombstone: The Great Chinese Famine, 1958-1962 - Yang Jisheng
The Mystical Body of Christ in the Modern World - Denis Fahey
Poland - Key to Europe - Raymond Leslie Buell
Documents on Nazism - Jeremy Noakes
America and the New Poland (1928) - H.H. Fisher
Rejoice O Youth: Rational Approaches to God's Existence and the Torah's Divine Origin - Avigdor Miller
Haller's Polish Army in France - Paul S. Valasek
The Future of the American Jew - Mordecai Menahem Kaplan
The Cheka: Lenin's Political Police - George Leggett
Red Dusk and the Morrow: Adventures and Investigations in Soviet Russia - Paul Dukes
Birkat Haminim - Yaakov Teppler
Nations: The Long History and Deep Roots of Political Ethnicity and Nationalism - Azar Gat
The Holocaust and Halakhah - Irving Rosenbaum
The Holocaust: Memories and History - Victoria Khiterer
Poland: a Story of the Land People and Literature - Georg Brandes
Poland 1945: A Red Cross Diary - Russell R. Johnston
"The Museum of An Extinct Race”—Fact Vs. Legend - Magda Veselska
The Living And The Dead: The Rise And Fall Of The Cult Of World War II In Russia - Nina Tumarkin (na archive.org)
Axis Rule in Occupied Europe: Laws of Occupation, Analysis of Government, Proposals for Redress - Raphael Lemkin,  Samantha Power
Remembering Deir Yassin: The Future of Israel and Palestine
The Virtue of Nationalism - Yoram Hazony
The Central Blue: Recollections and Reflections - John Slessor
Two Nations in Your Womb: Perceptions of Jews and Christians in Late Antiquity and the Middle Ages - Israel Jacob Yuval
Birkat Haminim - Yaakov Teppler
Life of Death: An Exchange - Israel Shahak
Pilsudski: Marshall of Poland - Eric James Patterson
Pilsudski: Builder of Poland - Grace Humphrey (online hathitrust.org)
The Pavement of Hell: 3 Leaders of the Judenrat - Leonard Tushnet
Social and Political History of the Jews in Poland 1919-1939 - Joseph Marcus
After Such Knowledge: Where Memory of the Holocaust Ends and History Begins - Eva Hoffman
Inquisition - Edward Peters
Stella: One Woman's True Tale of Evil, Betrayal and Survival in Hitler's Germany - Peter Wyden
Selling the Holocaust: From Auschwitz to Schindler, How History is Bought, Packaged, and Sold - Tim Cole
Stranger at Home: The Holocaust, Zionism, and American Judaism - Jacob Neusner
From the Kippah to the Cross: A Jew's Conversion to Catholicism - Jean-Marie Elie Setbon
The Dark Side of the Moon. With a preface by TS Eliot.